144
4 -2 -2 -2 1025 1025 1025 1025 -2
320 0 320 32 352 32 352 0
544 0 544 32 576 32 576 0
672 0 672 64 704 64 704 0
736 0 736 32 768 32 768 0
0 32 0 64 32 64 32 32
128 32 128 64 160 64 160 32
192 32 192 64 256 64 256 32
608 32 608 64 640 64 640 32
800 32 800 64 832 64 832 32
448 64 448 96 480 96 480 64
736 64 736 96 800 96 800 64
896 64 896 96 928 96 928 64
160 96 160 128 192 128 192 96
224 96 224 128 256 128 256 96
576 96 576 128 608 128 608 96
928 96 928 128 960 128 960 96
32 128 32 160 96 160 96 128
448 128 448 192 512 192 512 128
544 128 544 160 576 160 576 128
768 128 768 160 800 160 800 128
864 128 864 224 896 224 896 128
192 160 192 224 224 224 224 160
288 160 288 224 320 224 320 160
352 160 352 192 384 192 384 160
704 160 704 192 736 192 736 160
960 160 960 192 1024 192 1024 160
320 192 320 224 352 224 352 192
608 192 608 224 640 224 640 192
992 192 992 224 1024 224 1024 192
32 224 32 256 64 256 64 224
160 224 160 256 192 256 192 224
672 224 672 256 736 256 736 224
832 224 832 288 864 288 864 224
928 224 928 256 960 256 960 224
192 256 192 288 224 288 224 256
512 256 512 288 544 288 544 256
768 256 768 288 800 288 800 256
64 288 64 352 96 352 96 288
128 288 128 320 160 320 160 288
544 288 544 320 576 320 576 288
608 288 608 320 640 320 640 288
864 288 864 320 928 320 928 288
0 320 0 352 32 352 32 320
384 320 384 416 416 416 416 320
448 320 448 352 480 352 480 320
704 320 704 384 736 384 736 320
832 320 832 352 864 352 864 320
576 352 576 384 608 384 608 352
640 352 640 384 672 384 672 352
960 352 960 384 992 384 992 352
64 384 64 416 96 416 96 384
256 384 256 416 288 416 288 384
320 384 320 416 352 416 352 384
416 384 416 416 448 416 448 384
480 384 480 416 512 416 512 384
832 384 832 448 864 448 864 384
32 416 32 448 64 448 64 416
576 416 576 448 608 448 608 416
640 416 640 448 672 448 672 416
960 416 960 448 992 448 992 416
96 448 96 480 192 480 192 448
416 448 416 512 448 512 448 448
736 448 736 480 768 480 768 448
256 480 256 512 288 512 288 480
480 480 480 576 512 576 512 480
544 480 544 512 576 512 576 480
640 480 640 576 672 576 672 480
64 512 64 544 96 544 96 512
192 512 192 544 224 544 224 512
736 512 736 576 800 576 800 512
800 512 800 544 832 544 832 512
32 544 32 576 64 576 64 544
256 544 256 576 352 576 352 544
416 544 416 576 448 576 448 544
576 544 576 576 608 576 608 544
928 544 928 608 960 608 960 544
992 544 992 576 1024 576 1024 544
0 576 0 608 32 608 32 576
320 576 320 640 352 640 352 576
608 576 608 608 640 608 640 576
704 576 704 704 736 704 736 576
960 576 960 608 1024 608 1024 576
192 608 192 640 224 640 224 608
416 608 416 640 448 640 448 608
512 608 512 640 544 640 544 608
576 608 576 640 608 640 608 608
832 608 832 640 864 640 864 608
32 640 32 672 64 672 64 640
96 640 96 672 128 672 128 640
384 640 384 672 416 672 416 640
736 640 736 704 768 704 768 640
800 640 800 672 832 672 832 640
928 640 928 672 960 672 960 640
224 672 224 768 256 768 256 672
288 672 288 704 320 704 320 672
576 672 576 704 608 704 608 672
672 672 672 704 768 704 768 672
832 672 832 704 928 704 928 672
64 704 64 736 96 736 96 704
128 704 128 736 160 736 160 704
384 704 384 736 416 736 416 704
608 704 608 736 640 736 640 704
960 704 960 736 992 736 992 704
416 736 416 768 448 768 448 736
576 736 576 768 608 768 608 736
704 736 704 768 736 768 736 736
768 736 768 768 800 768 800 736
832 736 832 800 864 800 864 736
864 736 864 768 896 768 896 736
544 768 544 800 576 800 576 768
672 768 672 800 704 800 704 768
736 768 736 800 768 800 768 768
896 768 896 832 928 832 928 768
512 800 512 832 544 832 544 800
800 800 800 832 832 832 832 800
992 800 992 832 1024 832 1024 800
32 832 32 864 64 864 64 832
256 832 256 896 288 896 288 832
320 832 320 864 352 864 352 832
640 832 640 864 704 864 704 832
992 832 992 864 1024 864 1024 832
64 864 64 896 96 896 96 864
160 864 160 896 192 896 192 864
0 896 0 1024 32 1024 32 896
96 896 96 928 160 928 160 896
352 896 352 928 384 928 384 896
480 896 480 960 512 960 512 896
608 896 608 960 640 960 640 896
928 896 928 928 1024 928 1024 896
160 928 160 960 192 960 192 928
320 928 320 960 352 960 352 928
544 928 544 960 576 960 576 928
736 928 736 960 768 960 768 928
960 928 960 960 1024 960 1024 928
32 960 32 1024 64 1024 64 960
96 960 96 992 128 992 128 960
192 960 192 992 256 992 256 960
288 960 288 992 320 992 320 960
352 960 352 992 416 992 416 960
576 960 576 1024 608 1024 608 960
864 960 864 992 896 992 896 960
480 992 480 1024 512 1024 512 992
896 992 896 1024 928 1024 928 992
